111111111111111
111111111111111
000222000000000
000292000000000
000292222220000
000291141120000
000294411120000
000291141120000
000212212220000
000211141120000
000222111620000
000002222220000
000000000000000
000000000000000
000000000000000
