000000000000000
000000000000000
000000000000000
000022222222000
000021112112000
000021212492000
000021111492000
000021212492000
000021112112000
000022222512000
000000002222000
000000000000000
000000000000000
000000000000000
000000000000000