000000000000000
000000000000000
000000000000000
000022220000000
000021122222000
002221921112000
002111411112000
002122322222000
002511411200000
002221911200000
000021122200000
000022220000000
000000000000000
000000000000000
000000000000000